ENT
box 6 1 Press;tab;to;use;me!
sign 12 1 I'm;a;Sign!
MAP
11111111111111111111111111
10&00000000000000000000001
11111111111111111111111111
1111111100000N000001111111
11111111111111111100000111
11111100000111111111111111
11111111111111111111111111
11111111111111111111111111
11111100000111111111111111
11111111111111111111111111
11111111111111111111111111